  78888888888888
783 x xxxxxo    
182t2ttttt88yoez
788889      v888
4797918888888888
44444         xo
1313188888888t88
 ox  xx  x     q
r88t88tt888t8888
4               
3               
