7888888888888888
4e xxxxxxxxo    
1b8bbbbbbb88yoez
788889      v88y
4797918888888883
44444         xo
1313188888888b89
 oxc xx  x    q4 
r88b88bb888b888n
4
