7888888888888888
4e xxxxxxxxo    
1b8bbbbbbb88yoz 
788889      v889
4797918888888883
44444        xo 
1313188888b88889
 oxc xx  x   q 4  
r88b88bb888b888n
4
