7888888888888888
4  xxxxxxxxo    
1b8bbbbbbb88yoez
788889      v888
4797918888888888
44444         xo
1313188888888b88
 ox  xx  x     q
r88b88bb888b8888
4               
